++++++++++++++++++++++
+    + ++  ++   +++  +
        +    +++++++++
+++++  +++   ++++    +
++  ++  +++  ++ +  +++
++++     +   +++    ++
+   +  +   S      +  +
+++  +  +++  +++  ++ +
++++++++++++++++++++++